NO textures/bunkerW.png
SO textures/bunkerW.png
WE textures/bunkerW.png
EA textures/bunkerW.png
F 64, 64, 64 
C 64,64,64



11111111111111111111111111111111111
10000000000000000000000000000000001
10000000000000000000000000000000001
10000000000000000000000000000000001
10000000000000000000000000000000001
10000000000000111D11100000000000001
10000000000000100000100000000000001
10000000000000100000100000000000001
10000000000000D00S00D00000000000001
10000000000000100000100000000000001
10000000000000100000100000000000001
10000000000000111D11100000000000001
10000000000000000000000000000000001
10000000000000000000000000000000001
10000000000000000000000000000000001
10000000000000000000000000000000001
11111111111111111111111111111111111
