NO textures/bunkerW2.png
SO textures/bunkerW2.png
WE textures/bunkerW.png
EA textures/bunkerW.png
F 64, 64, 64 
C 64,64,64



111111111111111111111111111111111
100000000000000000000000000000001
100000000000000000000000000000001
100000000000000000000000000000001
100000000000000000000000000000001
1000000000000111D1110000000000001
100000000000010000010000000000001
1000000000000D00S00D0000000000001
100000000000010000010000000000001
1000000000000111D1110000000000001
100000000000000000000000000000001
100000000000000000000000000000001
100000000000000000000000000000001
100000000000000000000000000000001
111111111111111111111111111111111
