NO textures/bunkerW.png
SO textures/bunkerW.png
WE textures/bunkerW.png
EA textures/bunkerW.png

F 64, 64, 64 
C 64,64,64

111111111111111111111
101000001000000000001
101010101011111110001
100010100010000010001
111110101111101011101
100000101000101000001
101111101011101111111
101000001010100000101
101011111010111110101
101010001010100010101
101110101010101010101
100000101010001010001
1111111D1011111011101
1000D0101000100010001
101110101110101110111
101000100000100010101
101D11111111111010101
10D010000000000010001
101D1D111011111111101
1N1000D01000000000001
111111111111111111111