NO ./textures/lbluew.png
SO ./textures/bluew.png
WE ./textures/lbluew.png
EA ./textures/bluew.png

F 10, 10, 10
C 10, 10, 10

11111111111111111111
10000000000000000001
10000000000000000001
10001010101010101001
10000000000000000001
1000000001D100001001
10000000000000001001
10000000N00000001001
10000000000001111001
10000010000000000001
10000000000000000001
10000000000000000001
11111111111111111111