NO textures/bunkerW2.png
SO textures/bunkerW2.png
WE textures/bunkerW2.png
EA textures/bunkerW2.png


F 64, 64, 64 
C 64,64,64



111111111111111111111111111111111
100000000000000000000000000000001
100000000000000000000000000000001
100000000000000000000000000000001
100000000000000000000000000000001
1000000000001111D1100000000000001
100000000100000000000000000000001
1000000001000000N0000000000000001
100000000D00000000000000000000001
100000000100000000000000000000001
100000000100000000000000000000001
100000000000000000000000000000001
100000000000000000000000000000001
100000000000000000000000000000001
111111111111111111111111111111111
