NO textures/bunkerW2.png
SO textures/bunkerW2.png
WE textures/bunkerW2.png
EA textures/bunkerW2.png


F 64, 64, 64 
C 64,64,64



1111111
100S001
100D001
1000001
1111111
