NO ./textures/north.png
SO ./textures/south.png
WE ./textures/west.png
EA ./textures/east.png

F 153, 204, 255
C 153, 204, 255



1111111111111
1000000000001
1000000000001
1000000000001
1000000000001
100000W000001
1000000000001
1000000000001
1000000000001
1000000000001
1111111111111
