NO textures/simonkraft/wet_sponge.xpm
SO textures/simonkraft/wet_sponge.xpm
WE textures/simonkraft/wet_sponge.xpm
EA textures/simonkraft/wet_sponge.xpm
F 164,169,20
C 153,204,255

111111111111111111111111111111111111111111111111111111111111111111111111111111
101000001000000000000100000100000000000010000010000000000001000001000000000001
101010101011111110000101010101111111000010101010111111100001010101011111110001
100010100010000010000001010001000001000000101000100000100000010100010000010001
111110101111101011101111010111110101110111101011111010111011110101111101011101
100000101000101000000000010100010100000000001010001010000000000101000101000001
101111101011101111110111110101110111111011111010111011111101111101011101111111
101000001010100000100100000101010000010010000010101000001001000001010100000101
101011111010111110100101111101011111010010111110101111101001011111010111110101
101010001010100010100101000101010001010010100010101000101001010001010100010101
101110101010101010100111010101010101010011101010101010101001110101010101010101
100000101010001010000000010101000101000000001010100010100000000101010001010001
111111101011111011101111110101111101110111111010111110111011111101011111011101
100000101000100010000000010100010001000000001010001000100000000101000100010001
101110101110101110110111010111010111011011101011101011101101110101110101110111
101000100000100010100100010000010001010010001000001000101001000100000100010101
101011111111111010100101111111111101010010111111111110101001011111111111010101
100010000000000010000001000000000001000000100000000000100000010000000000010001
101010111011111111100001000000000001000010101110111111111000010000000000010001
1N1000001000000000000001000000000001000010000010000000000000010000000000010001
111111111111111111111111111111111111111111111111111111111111111111111111111111
