NO ./textures/bunkerW.png



SO ./textures/bunkerW.png



WE ./textures/bunkerW.png



EA ./textures/bunkerW.png

F 103, 99, 94
C 103, 99, 94

111   11111111111111111111111111
111111111000000001000000000000001
100000001100000000000000000000001
100000000100010000000000000000001
1101111111100000011100000000000N1
10000000001100000111011111111111
11110111111111011100000000001
11110111111111011101010000001
11000001110101011100000000001
10000000000000001100000000001
10000000000000001101010000001
110000011101010111110111000111
11110111 1110101 101111000001
11111111 111111 111111111111
