NO ./textures/north.png
SO ./textures/south.png
WE ./textures/west.png
EA ./textures/east.png

F 153, 204, 255
C 153, 204, 255

11111111111111111111
10000000000000000001
10000000000000000001
10001010101010101001
10000000000000000001
10000000000000001001
10000000000000001001
10000000W00000001001
10000000000001111001
10000000000000000001
10000000000000000001
10000000000000000001
11111111111111111111