NO ./path_to_the_north_texture
SO ./path_to_the_south_texture
WE ./path_to_the_west_texture
EA ./path_to_the_east_texture
F 255,100, 255 
C 255,30,0



1111111111111111111111111111111
1000000000000000000000000000001
1000111000101000000000000000001
1000100100010000000000000000001
1000111000101000000000000000001
1000000000N00000000000000000001
1111111111111111111111111111111