NO ./path_to_the_north_texture
SO ./path_to_the_south_texture
WE ./path_to_the_west_texture
EA ./path_to_the_east_texture

C 255,30,200
F 255,100,255





1111111111111111111111111111111
1000000000000000000000000000001
1000111000101000000010000000001
1000100100010000000000000000001
1000111000101000000000000000001
10000000001000000000N0000000001
1111111111111111111111111111111
