NO ./path_to_the_north_texture



SO ./path_to_the_south_texture



WE ./path_to_the_west_texture



EA ./path_to_the_east_texture



111   11111111111111111111111111
1N1111111000000001000000000000001
100000001100000000000000000000001
100000000100010000000000000000001
110111111110000001110000000000001
10000000001100000111011111111111
11110111111111011100000000001
11110111111111011101010000001
11000001110101011100000000001
10000000000000001100000000001
10000000000000001101010000001
110000011101010111110111000111
11110111 1110101 101111000001
11111111 111111 111111111111
