NO ./path_to_the_north_texture
SO ./path_to_the_south_texture
WE ./path_to_the_west_texture
EA ./path_to_the_east_texture
F 255,100, 255 
C 255,30,0



        1111111111111111111111111
        1000000000110000000000001
        1011000001110000000000001
        1001000000000N00000000001
111111111011000001110000000000001
10000000001100000111011111111111
11110111111111011100000010001
11110111111111011101010010001
11000001110101011100000010001
10000000000000001100000010001
10000000000000001101010010001
110000011101010111110111100111
11110111 1110101 101111010001
11111111 111111 111111111111
